...*..*G
......*.
...*..*.
...*....
.*..*...
.....*.*
***...*.
S.......
